{
  "levelHeight": 25,
  "levelWidth": 25,
  "level": [
    [4, 4, 4, 4, 4, 4, 4, 4, 4, 4, 4, 4, 4, 4, 4, 4, 4, 4, 4, 4, 4, 4, 4, 4, 4],
    [4, 1, 1, 1, 1, 1, 1, 1, 1, 1, 1, 1, 4, 1, 1, 1, 1, 1, 1, 1, 1, 1, 1, 1, 4],
    [4, 2, 4, 4, 4, 4, 1, 4, 4, 4, 4, 1, 4, 1, 4, 4, 4, 4, 1, 4, 4, 4, 4, 2, 4],
    [4, 1, 4, 4, 4, 4, 1, 4, 4, 4, 4, 1, 4, 1, 4, 4, 4, 4, 1, 4, 4, 4, 4, 1, 4],
    [4, 1, 1, 1, 1, 1, 1, 1, 1, 1, 1, 1, 1, 1, 1, 1, 1, 1, 1, 1, 1, 1, 1, 1, 4],
    [4, 1, 4, 4, 4, 4, 1, 4, 1, 4, 4, 4, 4, 4, 4, 4, 1, 4, 1, 4, 4, 4, 4, 1, 4],
    [4, 1, 4, 4, 4, 4, 1, 4, 1, 4, 4, 4, 4, 4, 4, 4, 1, 4, 1, 4, 4, 4, 4, 1, 4],
    [4, 1, 1, 1, 1, 1, 1, 4, 1, 1, 1, 1, 4, 1, 1, 1, 1, 4, 1, 1, 1, 1, 1, 1, 4],
    [4, 4, 4, 4, 4, 4, 1, 4, 4, 4, 4, 1, 4, 1, 4, 4, 4, 4, 1, 4, 4, 4, 4, 4, 4],
    [0, 0, 0, 0, 0, 4, 1, 4, 0, 0, 0, 0, 11, 0, 0, 0, 0, 4, 1, 4, 0, 0, 0, 0, 0],
    [0, 0, 0, 0, 0, 4, 1, 4, 0, 4, 4, 4, 20, 4, 4, 4, 0, 4, 1, 4, 0, 0, 0, 0, 0],
    [4, 4, 4, 4, 4, 4, 1, 4, 0, 4, 0, 0, 0, 0, 0, 4, 0, 4, 1, 4, 4, 4, 4, 4, 4],
    [0, 0, 0, 0, 0, 0, 1, 1, 0, 4, 12, 0, 13, 0, 14, 4, 0, 1, 1, 0, 0, 0, 0, 0, 0],
    [4, 4, 4, 4, 4, 4, 1, 4, 0, 4, 0, 0, 0, 0, 0, 4, 0, 4, 1, 4, 4, 4, 4, 4, 4],
    [0, 0, 0, 0, 0, 4, 1, 4, 0, 4, 4, 4, 4, 4, 4, 4, 0, 4, 1, 4, 0, 0, 0, 0, 0],
    [0, 0, 0, 0, 0, 4, 1, 4, 0, 0, 0, 0, 0, 0, 0, 0, 0, 4, 1, 4, 0, 0, 0, 0, 0],
    [4, 4, 4, 4, 4, 4, 1, 4, 0, 4, 4, 4, 4, 4, 4, 4, 0, 4, 1, 4, 4, 4, 4, 4, 4],
    [4, 1, 1, 1, 1, 1, 1, 1, 1, 1, 1, 1, 4, 1, 1, 1, 1, 1, 1, 1, 1, 1, 1, 1, 4],
    [4, 1, 4, 4, 4, 4, 1, 4, 4, 4, 4, 1, 4, 1, 4, 4, 4, 4, 1, 4, 4, 4, 4, 1, 4],
    [4, 2, 1, 1, 1, 4, 1, 1, 1, 1, 1, 1, 10, 1, 1, 1, 1, 1, 1, 4, 1, 1, 1, 2, 4],
    [4, 4, 4, 4, 1, 4, 1, 4, 1, 4, 4, 4, 4, 4, 4, 4, 1, 4, 1, 4, 1, 4, 4, 4, 4],
    [4, 1, 1, 1, 1, 1, 1, 4, 1, 1, 1, 1, 4, 1, 1, 1, 1, 4, 1, 1, 1, 1, 1, 1, 4],
    [4, 1, 4, 4, 4, 4, 4, 4, 4, 4, 4, 1, 4, 1, 4, 4, 4, 4, 4, 4, 4, 4, 4, 1, 4],
    [4, 1, 1, 1, 1, 1, 1, 1, 1, 1, 1, 1, 1, 1, 1, 1, 1, 1, 1, 1, 1, 1, 1, 1, 4],
    [4, 4, 4, 4, 4, 4, 4, 4, 4, 4, 4, 4, 4, 4, 4, 4, 4, 4, 4, 4, 4, 4, 4, 4, 4]
  ],
  "score": 0,
  "lives": 3
}